1111111111111111111111111111111111
1E0000000000000C00000C000C00000001
1111110010101010001001000000010101
1C0000000000000C000001000CC0000001
1010010100100000101001000C00010101
10P000000C00C0000000C0000C00C000C1
1010010010101010001001111000010101
10100101001000001010010000C0010101
10P000000C00C0000000010000C00C00C1
1111111111111111111111111111111111